11111111111
1E100000101
10000001101
1000C00P001
10000001101
11111111111
