1111111111
1P00000001
1110111101
100C001001
1111111101
1E00C00001
1111111111
