1111111111
1P000C00E1
1110111101
1000001001
1011111101
1000C00001
1111111111
