11111111111
1E000000001
10000000001
10000000001
10000000001
10000000001
10000000001
10000000001
10000000001
10000000001
1000C00P001
11111111111
