1111111111
1P000000E1
1110111101
100C001001
1011111101
1000C00001
1111111111
