1111111111111111111111
1E100000101000000C0001
1000000111000C00000001
1000C00P0010000C000001
10C00001100C0000000001
1000000110000000000001
10C00001100C0000000001
1111111111111111111111
